7 7
0 1 1 0 1 3 2 
1 1 2 3 1 1 1 
0 1 2 2 1 2 2 
0 1 1 0 1 1 5 
1 1 5 0 1 1 2 
1 1 2 5 3 0 0 
1 1 0 1 2 1 1 
