8 8
1 2 0 1 1 1 2 1 
1 2 1 1 0 1 1 1 
1 5 5 5 1 1 2 1 
1 0 1 0 0 0 5 1 
1 1 2 1 0 1 2 1 
1 5 3 3 1 1 1 1 
1 0 1 1 2 5 2 1 
1 0 0 1 3 5 5 1 
