9 9
0 1 1 1 1 1 1 2 1 
2 3 2 3 1 1 1 1 5 
2 2 1 2 0 0 1 0 5 
2 1 0 0 0 1 1 0 1 
2 1 1 1 1 2 5 1 0 
0 0 0 1 1 0 1 1 1 
0 1 2 1 0 0 0 0 1 
2 1 2 3 0 2 5 1 0 
2 1 1 2 1 3 1 0 0 
